09423350
10256500
10257500
10257548
10257720
10258500
10259000
10259200
10260500
10260950
10265150
10289000
10289500
10290500
10291500
10293000
10296500
10308200
10308783
10308789
10308794
10310000
103366092
10336610
10336660
10336676
10336780
10338500
10338700
10340500
10343000
10343500
11014000
11015000
11022200
11023340
11025500
11028500
11042400
11044250
11044350
11044800
11045300
11046360
11046530
11047300
11048600
11051499
11055500
11055800
11057500
11058500
11058600
11065000
11069500
11073300
11075720
11085000
11088500
11089500
11092450
11098000
11109600
11111500
11113000
11113500
11118500
11119500
11119940
11120500
11120520
11123000
11123500
11124500
11129800
11135800
11137900
11141050
11141280
11143000
11143200
11148900
11149400
11149900
11151300
11152000
11153000
11153650
11156500
11159200
11160000
11160500
11161000
11162500
11162570
11162620
11162630
11164500
11169500
11169800
11170000
11172175
11172945
11173200
11173500
11173510
11173575
11174000
11176400
11176500
11180825
11180900
11180960
11181040
11182500
11200800
11203580
11204100
11224500
11253310
11264500
11266500
11274500
11274630
11274790
11277300
11278000
11278300
11278400
11284400
11345500
11372000
11381500
11383500
11390000
11402000
11413000
11427000
11447360
11449500
11451300
11456000
11458000
11458433
11458500
11459500
11460000
11460400
11460600
11460750
11461500
11462500
11463170
11463200
11463900
11465350
11465680
11465750
11466320
11466800
11467200
11467510
11468000
11468500
11468900
11469000
11475800
11476600
11478500
11480390
11481200
11481500
11482500
11521500
11525530
11525670
