01060000
01068910
01076000
01078000
01085000
01100561
01104460
01111212
01116000
01117800
01170100
01179500
01186000
01187300
01202501
01209901
01304500
01311500
01349150
01349700
01349810
01362200
01381500
01388000
01397000
01398000
01398500
01410150
01422500
01430000
01434017
01440000
01440485
01452000
01473000
01474000
01480617
01483700
01484100
01510000
01534300
01545000
01545600
01567500
01576787
01581920
01585100
01589330
01591000
01594526
01595800
01609000
01632000
01632900
01638350
01643805
01646305
01653600
01661500
01665500
02011500
02039000
02055100
02058400
02064000
02072000
02072500
02079640
02085000
02086849
02088000
02095181
02103000
02104220
02111500
02118000
02142654
02157490
02160381
02173212
02196835
02207400
02207435
02207448
02211375
02246000
02266200
02295013
02298880
02300018
02300210
02301990
02329500
02329600
02335870
02343225
02344350
02344396
02370000
02390000
02400680
02423380
02453000
02471078
02479945
03026500
03072000
03106000
03159540
03175500
03186500
03198350
03202750
03208950
03281100
03282040
03289000
03292500
03295400
03295890
03297800
03298550
03302000
03310300
03318800
03351500
03357350
03364200
03431599
03456991
03466208
03559500
03575100
03596000
03610200
04031000
04046000
04126970
04146000
04153500
04174518
04184500
04185440
04197100
04216418
04227000
04229500
04250750
04252500
04275000
04282780
05342000
05427948
05439000
05501000
05514840
05514860
05527950
05530990
05541710
05579725
06224000
06309200
06430770
06716100
06819185
06878000
06914000
06921200
06921590
06928300
06935770
06935980
06936475
07010094
07017200
07019072
07019195
07020550
07048550
07049000
07055875
07103780
07169800
07176500
07188838
07189100
07189540
07189542
07215500
07342480
07375280
07382000
08010000
08014800
08031000
08033900
08049700
08066300
08068325
08078000
08120500
08155400
08158380
08158827
08164504
08165300
08177300
08267500
08316000
09034900
09035500
09036000
09046490
09172500
09296800
09404450
09404900
09471310
09484500
10113500
10134500
10172200
10322150
10336730
12041200
12058790
12082500
12088000
12091200
12093500
12108500
12119000
12144500
12157250
12323600
12414900
13018350
13150430
13331500
14152500
14154500
14155500
14185900
14198400
14219000
14219800
14306340
14309500
14314700
